................................................
.........................---.................---
--.........---..................................
................................................
....---..........................----...........
..............................................--
---.............................................
................................................
............---.......---..........-----........
............................---...............--
................................................
------------------------------------------------
